AanI	TTATAA	F	yes
AarI	CACCTGC (4/8)	F	-
AasI	GACNNNNNNGTC	F	yes
AatI	AGGCCT	O	yes
AatII	GACGTC	FIKMNORV	yes
AbsI	CCTCGAGG	I	-
AccI	GTMKAC	BJKMNOQRSUX	yes
AccII	CGCG	JK	yes
AccIII	TCCGGA	JKR	yes
Acc16I	TGCGCA	IV	yes
Acc36I	ACCTGC (4/8)	I	yes
Acc65I	GGTACC	FINRV	yes
AccB1I	GGYRCC	IV	yes
AccB7I	CCANNNNNTGG	IRV	yes
AccBSI	CCGCTC (-3/-3)	IV	yes
AciI	CCGC (-3/-1)	N	yes
AclI	AACGTT	INV	yes
AclWI	GGATC (4/5)	I	yes
AcoI	YGGCCR	I	yes
AcsI	RAATTY	IV	yes
AcuI	CTGAAG (16/14)	IN	yes
AcvI	CACGTG	QX	yes
AcyI	GRCGYC	J	yes
AdeI	CACNNNGTG	F	yes
AfaI	GTAC	K	yes
AfeI	AGCGCT	IN	yes
AfiI	CCNNNNNNNGG	V	yes
AflII	CTTAAG	JKN	yes
AflIII	ACRYGT	MN	yes
AgeI	ACCGGT	JNR	yes
AgsI	TTSAA	I	-
AhdI	GACNNNNNGTC	N	yes
AhlI	ACTAGT	IV	yes
AjiI	CACGTC (-3/-3)	F	yes
AjnI	CCWGG	I	yes
AjuI	(7/12) GAANNNNNNNTTGG (11/6)	F	-
AleI	CACNNNNGTG	N	yes
AlfI	(10/12) GCANNNNNNTGC (12/10)	F	-
AloI	(7/12) GAACNNNNNNTCC (12/7)	F	-
AluI	AGCT	BCFHIJKMNOQRSUVXY	yes
AluBI	AGCT	I	yes
AlwI	GGATC (4/5)	N	yes
Alw21I	GWGCWC	F	yes
Alw26I	GTCTC (1/5)	F	yes
Alw44I	GTGCAC	FJO	yes
AlwNI	CAGNNNCTG	N	yes
Ama87I	CYCGRG	IV	yes
Aor13HI	TCCGGA	K	yes
Aor51HI	AGCGCT	K	yes
ApaI	GGGCCC	BFIJKMNOQRSUVX	yes
ApaLI	GTGCAC	CKNU	yes
ApeKI	GCWGC	N	yes
ApoI	RAATTY	N	yes
ArsI	(8/13) GACNNNNNNTTYG (11/6)	I	-
AscI	GGCGCGCC	N	yes
AseI	ATTAAT	JNO	yes
AsiGI	ACCGGT	IV	yes
AsiSI	GCGATCGC	N	yes
AspI	GACNNNGTC	M	yes
Asp700I	GAANNNNTTC	M	yes
Asp718I	GGTACC	M	yes
AspA2I	CCTAGG	IV	yes
AspEI	GACNNNNNGTC	M	yes
AspLEI	GCGC	IV	yes
AspS9I	GGNCC	IV	yes
AssI	AGTACT	U	yes
AsuII	TTCGAA	C	yes
AsuC2I	CCSGG	I	yes
AsuHPI	GGTGA (8/7)	IV	yes
AsuNHI	GCTAGC	IV	yes
AvaI	CYCGRG	BJMNOQRUX	yes
AvaII	GGWCC	JKMNRY	yes
AviII	TGCGCA	M	yes
AvrII	CCTAGG	N	yes
AxyI	CCTNAGG	J	yes
BaeI	(10/15) ACNNNNGTAYC (12/7)	N	-
BaeGI	GKGCMC	N	yes
BalI	TGGCCA	JKQRX	yes
BamHI	GGATCC	BCFHIJKMNOQRSUVXY	yes
BanI	GGYRCC	NORU	yes
BanII	GRGCYC	KNORX	yes
BanIII	ATCGAT	O	yes
BarI	(7/12) GAAGNNNNNNTAC (12/7)	I	-
BasI	CCANNNNNTGG	U	yes
BauI	CACGAG (-5/-1)	F	yes
BbrPI	CACGTG	MO	yes
BbsI	GAAGAC (2/6)	N	yes
BbuI	GCATGC	R	yes
BbvI	GCAGC (8/12)	N	yes
Bbv12I	GWGCWC	IV	yes
BbvCI	CCTCAGC (-5/-2)	N	yes
BccI	CCATC (4/5)	N	yes
BceAI	ACGGC (12/14)	N	yes
BcgI	(10/12) CGANNNNNNTGC (12/10)	N	-
BciVI	GTATCC (6/5)	N	yes
BclI	TGATCA	CFJMNORSUY	yes
BcnI	CCSGG	FK	yes
BcoDI	GTCTC (1/5)	N	yes
BcuI	ACTAGT	F	yes
BdaI	(10/12) TGANNNNNNTCA (12/10)	F	-
BfaI	CTAG	N	yes
BfiI	ACTGGG (5/4)	F	yes
BfmI	CTRYAG	F	yes
BfoI	RGCGCY	F	yes
BfrI	CTTAAG	MO	yes
BfuI	GTATCC (6/5)	F	yes
BfuAI	ACCTGC (4/8)	N	yes
BfuCI	GATC	N	yes
BglI	GCCNNNNNGGC	CFHIJKMNOQRUVXY	yes
BglII	AGATCT	BCFHIJKMNOQRSUVXY	yes
BisI	G5mCNGC	I	yes
BlnI	CCTAGG	KMS	yes
BlpI	GCTNAGC	N	yes
BlsI	G5mCNGC	I	yes
BmcAI	AGTACT	V	yes
Bme18I	GGWCC	IV	yes
Bme1390I	CCNGG	F	yes
BmeRI	GACNNNNNGTC	V	yes
BmeT110I	CYCGRG	K	yes
BmgBI	CACGTC (-3/-3)	N	yes
BmgT120I	GGNCC	K	yes
BmiI	GGNNCC	V	yes
BmrI	ACTGGG (5/4)	N	yes
BmrFI	CCNGG	V	yes
BmsI	GCATC (5/9)	F	yes
BmtI	GCTAGC	INV	yes
BmuI	ACTGGG (5/4)	I	yes
BoxI	GACNNNNGTC	F	yes
BpiI	GAAGAC (2/6)	F	yes
BplI	(8/13) GAGNNNNNCTC (13/8)	F	-
BpmI	CTGGAG (16/14)	IN	yes
Bpu10I	CCTNAGC (-5/-2)	FINV	yes
Bpu14I	TTCGAA	IV	yes
Bpu1102I	GCTNAGC	FK	yes
BpuAI	GAAGAC (2/6)	M	yes
BpuEI	CTTGAG (16/14)	N	yes
BpuMI	CCSGG	V	yes
BpvUI	CGATCG	V	yes
BsaI	GGTCTC (1/5)	N	yes
Bsa29I	ATCGAT	I	yes
BsaAI	YACGTR	N	yes
BsaBI	GATNNNNATC	N	yes
BsaHI	GRCGYC	N	yes
BsaJI	CCNNGG	N	yes
BsaMI	GAATGC (1/-1)	R	yes
BsaWI	WCCGGW	N	yes
BsaXI	(9/12) ACNNNNNCTCC (10/7)	N	yes
Bsc4I	CCNNNNNNNGG	I	yes
Bse1I	ACTGG (1/-1)	IV	yes
Bse8I	GATNNNNATC	IV	yes
Bse21I	CCTNAGG	IV	yes
Bse118I	RCCGGY	IV	yes
BseAI	TCCGGA	CM	yes
BseBI	CCWGG	C	yes
BseCI	ATCGAT	C	yes
BseDI	CCNNGG	F	yes
Bse3DI	GCAATG (2/0)	IV	yes
BseGI	GGATG (2/0)	F	yes
BseJI	GATNNNNATC	F	yes
BseLI	CCNNNNNNNGG	F	yes
BseMI	GCAATG (2/0)	F	yes
BseMII	CTCAG (10/8)	F	yes
BseNI	ACTGG (1/-1)	F	yes
BsePI	GCGCGC	IV	yes
BseRI	GAGGAG (10/8)	N	yes
BseSI	GKGCMC	F	yes
BseXI	GCAGC (8/12)	F	yes
BseX3I	CGGCCG	IV	yes
BseYI	CCCAGC (-5/-1)	N	yes
BsgI	GTGCAG (16/14)	N	yes
Bsh1236I	CGCG	F	yes
Bsh1285I	CGRYCG	F	yes
BshFI	GGCC	C	yes
BshNI	GGYRCC	F	yes
BshTI	ACCGGT	F	yes
BshVI	ATCGAT	V	yes
BsiEI	CGRYCG	N	yes
BsiHKAI	GWGCWC	N	yes
BsiHKCI	CYCGRG	QX	yes
BsiSI	CCGG	C	yes
BsiWI	CGTACG	MNO	yes
BslI	CCNNNNNNNGG	N	yes
BslFI	GGGAC (10/14)	I	yes
BsmI	GAATGC (1/-1)	JMNOS	yes
BsmAI	GTCTC (1/5)	N	yes
BsmBI	CGTCTC (1/5)	N	yes
BsmFI	GGGAC (10/14)	N	yes
BsnI	GGCC	V	yes
Bso31I	GGTCTC (1/5)	IV	yes
BsoBI	CYCGRG	N	yes
Bsp13I	TCCGGA	IV	yes
Bsp19I	CCATGG	IV	yes
Bsp68I	TCGCGA	F	yes
Bsp119I	TTCGAA	F	yes
Bsp120I	GGGCCC	F	yes
Bsp143I	GATC	F	yes
Bsp1286I	GDGCHC	JKNR	yes
Bsp1407I	TGTACA	FK	yes
Bsp1720I	GCTNAGC	IV	yes
BspACI	CCGC (-3/-1)	I	yes
BspCNI	CTCAG (9/7)	N	yes
BspDI	ATCGAT	N	yes
BspEI	TCCGGA	N	yes
BspFNI	CGCG	I	yes
BspHI	TCATGA	N	yes
BspLI	GGNNCC	F	yes
BspMI	ACCTGC (4/8)	N	yes
BspOI	GCTAGC	F	yes
BspPI	GGATC (4/5)	F	yes
BspQI	GCTCTTC (1/4)	N	yes
BspTI	CTTAAG	F	yes
BspT104I	TTCGAA	K	yes
BspT107I	GGYRCC	K	yes
BsrI	ACTGG (1/-1)	N	yes
BsrBI	CCGCTC (-3/-3)	N	yes
BsrDI	GCAATG (2/0)	N	yes
BsrFI	RCCGGY	N	yes
BsrGI	TGTACA	N	yes
BsrSI	ACTGG (1/-1)	R	yes
BssAI	RCCGGY	C	yes
BssECI	CCNNGG	I	yes
BssHII	GCGCGC	JKMNOQRSX	yes
BssKI	CCNGG	N	yes
BssMI	GATC	V	yes
BssNI	GRCGYC	V	yes
BssNAI	GTATAC	IV	yes
BssSI	CACGAG (-5/-1)	N	yes
BssT1I	CCWWGG	IV	yes
Bst6I	CTCTTC (1/4)	IV	yes
Bst98I	CTTAAG	R	yes
Bst1107I	GTATAC	FKM	yes
BstACI	GRCGYC	I	yes
BstAFI	CTTAAG	I	yes
BstAPI	GCANNNNNTGC	IN	yes
BstAUI	TGTACA	IV	yes
BstBI	TTCGAA	N	yes
Bst2BI	CACGAG (-5/-1)	IV	yes
BstBAI	YACGTR	IV	yes
Bst4CI	ACNGT	IV	yes
BstC8I	GCNNGC	I	yes
BstDEI	CTNAG	IV	yes
BstDSI	CCRYGG	IV	yes
BstEII	GGTNACC	CHJMNORSU	yes
BstENI	CCTNNNNNAGG	IV	yes
BstF5I	GGATG (2/0)	IV	yes
BstFNI	CGCG	IV	yes
BstH2I	RGCGCY	IV	yes
BstHHI	GCGC	IV	yes
BstKTI	GATC	I	yes
BstMAI	GTCTC (1/5)	IV	yes
BstMBI	GATC	IV	yes
BstMCI	CGRYCG	IV	yes
BstMWI	GCNNNNNNNGC	I	yes
BstNI	CCWGG	N	yes
BstNSI	RCATGY	IV	yes
BstOI	CCWGG	R	yes
BstPI	GGTNACC	K	yes
BstPAI	GACNNNNGTC	IV	yes
BstSCI	CCNGG	I	yes
BstSFI	CTRYAG	I	yes
BstSLI	GKGCMC	I	yes
BstSNI	TACGTA	IV	yes
BstUI	CGCG	N	yes
Bst2UI	CCWGG	IV	yes
BstV1I	GCAGC (8/12)	I	yes
BstV2I	GAAGAC (2/6)	IV	yes
BstXI	CCANNNNNNTGG	FHIJKMNOQRVX	yes
BstX2I	RGATCY	IV	yes
BstYI	RGATCY	N	yes
BstZI	CGGCCG	R	yes
BstZ17I	GTATAC	N	yes
BsuI	GTATCC (6/5)	I	yes
Bsu15I	ATCGAT	F	yes
Bsu36I	CCTNAGG	NR	yes
BsuRI	GGCC	FI	yes
BsuTUI	ATCGAT	X	yes
BtgI	CCRYGG	N	yes
BtgZI	GCGATG (10/14)	N	yes
BtrI	CACGTC (-3/-3)	IV	yes
BtsI	GCAGTG (2/0)	N	-
BtsCI	GGATG (2/0)	N	yes
BtsIMutI	CAGTG (2/0)	N	-
BtuMI	TCGCGA	V	yes
BveI	ACCTGC (4/8)	F	yes
Cac8I	GCNNGC	N	yes
CaiI	CAGNNNCTG	F	yes
CciI	TCATGA	I	yes
CciNI	GCGGCCGC	IV	yes
CelII	GCTNAGC	M	yes
CfoI	GCGC	MRS	yes
CfrI	YGGCCR	F	yes
Cfr9I	CCCGGG	FO	yes
Cfr10I	RCCGGY	FKO	yes
Cfr13I	GGNCC	FO	yes
Cfr42I	CCGCGG	F	yes
ClaI	ATCGAT	BHKMNQRSU	yes
CpoI	CGGWCCG	FK	yes
CseI	GACGC (5/10)	F	yes
CsiI	ACCWGGT	F	yes
CspI	CGGWCCG	OR	yes
Csp6I	GTAC	F	yes
Csp45I	TTCGAA	O	yes
CspAI	ACCGGT	C	yes
CspCI	(11/13) CAANNNNNGTGG (12/10)	N	-
CviAII	CATG	N	yes
CviJI	RGCY	QX	yes
CviKI-1	RGCY	N	yes
CviQI	GTAC	N	yes
DdeI	CTNAG	BMNOQRS	yes
DinI	GGCGCC	V	yes
DpnI	G6mATC	BEFKMNOQRSX	yes
DpnII	GATC	N	yes
DraI	TTTAAA	BFIJKMNOQRSUVXY	yes
DraII	RGGNCCY	M	yes
DraIII	CACNNNGTG	IMNV	yes
DrdI	GACNNNNNNGTC	N	yes
DriI	GACNNNNNGTC	I	yes
DseDI	GACNNNNNNGTC	IV	yes
EaeI	YGGCCR	KN	yes
EagI	CGGCCG	N	yes
Eam1104I	CTCTTC (1/4)	F	yes
Eam1105I	GACNNNNNGTC	FK	yes
EarI	CTCTTC (1/4)	N	yes
EciI	GGCGGA (11/9)	N	yes
Ecl136II	GAGCTC	F	yes
EclXI	CGGCCG	MS	yes
Eco24I	GRGCYC	F	yes
Eco31I	GGTCTC (1/5)	F	yes
Eco32I	GATATC	F	yes
Eco47I	GGWCC	FO	yes
Eco47III	AGCGCT	FMOR	yes
Eco52I	CGGCCG	FKO	yes
Eco57I	CTGAAG (16/14)	F	yes
Eco72I	CACGTG	F	yes
Eco81I	CCTNAGG	FKO	yes
Eco88I	CYCGRG	F	yes
Eco91I	GGTNACC	F	yes
Eco105I	TACGTA	FO	yes
Eco130I	CCWWGG	F	yes
Eco147I	AGGCCT	F	yes
EcoICRI	GAGCTC	IRV	yes
Eco57MI	CTGRAG (16/14)	F	-
EcoNI	CCTNNNNNAGG	N	yes
EcoO65I	GGTNACC	K	yes
EcoO109I	RGGNCCY	FJKN	yes
EcoRI	GAATTC	BCFHIJKMNOQRSUVXY	yes
EcoRII	CCWGG	FJMOS	yes
EcoRV	GATATC	BCHIJKMNOQRSUVXY	yes
EcoT14I	CCWWGG	K	yes
EcoT22I	ATGCAT	KO	yes
EcoT38I	GRGCYC	J	yes
Eco53kI	GAGCTC	N	yes
EgeI	GGCGCC	I	yes
EheI	GGCGCC	FO	yes
ErhI	CCWWGG	IV	yes
Esp3I	CGTCTC (1/5)	F	yes
FaeI	CATG	I	yes
FaiI	YATR	I	-
FalI	(8/13) AAGNNNNNCTT (13/8)	I	-
FaqI	GGGAC (10/14)	F	yes
FatI	CATG	IN	yes
FauI	CCCGC (4/6)	IN	yes
FauNDI	CATATG	IV	yes
FbaI	TGATCA	K	yes
FblI	GTMKAC	IV	yes
Fnu4HI	GCNGC	N	yes
FokI	GGATG (9/13)	IJKMNVX	yes
FriOI	GRGCYC	IV	yes
FseI	GGCCGGCC	N	yes
FspI	TGCGCA	JNO	yes
FspAI	RTGCGCAY	F	-
FspBI	CTAG	F	yes
FspEI	C5mCNNNNNNNNNNNN	N	-
Fsp4HI	GCNGC	I	yes
GlaI	G5mCG5mC	I	yes
GluI	G5mCNG5mC	I	yes
GsaI	CCCAGC (-1/-5)	I	yes
GsuI	CTGGAG (16/14)	F	yes
HaeII	RGCGCY	JKNOR	yes
HaeIII	GGCC	BHIJKMNOQRSUXY	yes
HapII	CCGG	K	yes
HgaI	GACGC (5/10)	IN	yes
HhaI	GCGC	BFJKNOQRUY	yes
Hin1I	GRCGYC	FKO	yes
Hin1II	CATG	F	yes
Hin4I	(8/13) GAYNNNNNVTC (13/8)	F	-
Hin6I	GCGC	F	yes
HinP1I	GCGC	N	yes
HincII	GTYRAC	BFHJKNOQRUXY	yes
HindII	GTYRAC	IMV	yes
HindIII	AAGCTT	BCFHIJKMNOQRSUVXY	yes
HinfI	GANTC	BCFHIJKMNOQRUVXY	yes
HpaI	GTTAAC	BCHIJKMNOQRSUVX	yes
HpaII	CCGG	BFIMNOQRSUVX	yes
HphI	GGTGA (8/7)	FN	yes
Hpy8I	GTNNAC	F	yes
Hpy99I	CGWCG	N	yes
Hpy166II	GTNNAC	N	yes
Hpy188I	TCNGA	N	yes
Hpy188III	TCNNGA	N	yes
HpyAV	CCTTC (6/5)	N	yes
HpyCH4III	ACNGT	N	yes
HpyCH4IV	ACGT	N	yes
HpyCH4V	TGCA	N	yes
HpyF3I	CTNAG	F	yes
HpyF10VI	GCNNNNNNNGC	F	yes
Hsp92I	GRCGYC	R	yes
Hsp92II	CATG	R	yes
HspAI	GCGC	IV	yes
KasI	GGCGCC	N	yes
KflI	GGGWCCC	F	yes
KpnI	GGTACC	BCFHIJKMNOQRSUVXY	yes
Kpn2I	TCCGGA	F	yes
KspI	CCGCGG	MS	yes
Ksp22I	TGATCA	IV	yes
KspAI	GTTAAC	F	yes
Kzo9I	GATC	I	yes
LguI	GCTCTTC (1/4)	F	yes
LpnPI	C5mCDGNNNNNNNNNN	N	-
Lsp1109I	GCAGC (8/12)	F	yes
LweI	GCATC (5/9)	F	yes
MabI	ACCWGGT	I	yes
MaeI	CTAG	M	yes
MaeII	ACGT	M	yes
MaeIII	GTNAC	M	-
MalI	G6mATC	I	yes
MauBI	CGCGCGCG	F	-
MbiI	CCGCTC (-3/-3)	F	yes
MboI	GATC	BCFKNQRUXY	yes
MboII	GAAGA (8/7)	FIJKNOQRVX	yes
MfeI	CAATTG	N	yes
MflI	RGATCY	K	yes
MhlI	GDGCHC	IV	yes
MlsI	TGGCCA	F	yes
MluI	ACGCGT	BFHIJKMNOQRSUVX	yes
MluCI	AATT	N	yes
MluNI	TGGCCA	M	yes
MlyI	GAGTC (5/5)	N	yes
Mly113I	GGCGCC	I	yes
MmeI	TCCRAC (20/18)	N	yes
MnlI	CCTC (7/6)	FINQVX	yes
Mph1103I	ATGCAT	F	yes
MreI	CGCCGGCG	F	yes
MroI	TCCGGA	MO	yes
MroNI	GCCGGC	IV	yes
MroXI	GAANNNNTTC	IV	yes
MscI	TGGCCA	BNO	yes
MseI	TTAA	BN	yes
MslI	CAYNNNNRTG	N	yes
MspI	CCGG	FHIJKMNOQRSUVXY	yes
Msp20I	TGGCCA	IV	yes
MspA1I	CMGCKG	INRV	yes
MspCI	CTTAAG	C	yes
MspJI	5mCNNRNNNNNNNNN	N	-
MspR9I	CCNGG	I	yes
MssI	GTTTAAAC	F	yes
MunI	CAATTG	FKM	yes
MvaI	CCWGG	FMOS	yes
Mva1269I	GAATGC (1/-1)	F	yes
MvnI	CGCG	M	yes
MvrI	CGATCG	U	yes
MwoI	GCNNNNNNNGC	N	yes
NaeI	GCCGGC	CKMNOU	yes
NarI	GGCGCC	JMNOQRUX	yes
NciI	CCSGG	JNOR	yes
NcoI	CCATGG	BCFHJKMNOQRSUXY	yes
NdeI	CATATG	BFJKMNQRSXY	yes
NdeII	GATC	JMR	yes
NgoMIV	GCCGGC	N	yes
NheI	GCTAGC	BCFJKMNOQRSUX	yes
NlaIII	CATG	N	yes
NlaIV	GGNNCC	N	yes
NmeAIII	GCCGAG (21/19)	N	yes
NmuCI	GTSAC	F	yes
NotI	GCGGCCGC	BCFHJKMNOQRSUXY	yes
NruI	TCGCGA	BCIJKMNOQRUX	yes
NsbI	TGCGCA	FK	yes
NsiI	ATGCAT	BHJMNQRSU	yes
NspI	RCATGY	MN	yes
NspV	TTCGAA	JO	yes
OliI	CACNNNNGTG	F	yes
PacI	TTAATTAA	FNO	-
PaeI	GCATGC	F	yes
PaeR7I	CTCGAG	N	yes
PagI	TCATGA	F	yes
PalAI	GGCGCGCC	I	yes
PasI	CCCWGGG	F	-
PauI	GCGCGC	F	yes
PceI	AGGCCT	IV	yes
PciI	ACATGT	IN	yes
PciSI	GCTCTTC (1/4)	I	yes
PcsI	W5mCGNNNNNNN5mCGW	I	-
PctI	GAATGC (1/-1)	IV	yes
PdiI	GCCGGC	F	yes
PdmI	GAANNNNTTC	F	yes
PfeI	GAWTC	F	yes
Pfl23II	CGTACG	F	yes
PflFI	GACNNNGTC	N	yes
PflMI	CCANNNNNTGG	N	yes
PfoI	TCCNGGA	F	-
PhoI	GGCC	N	yes
PinAI	ACCGGT	BMQX	yes
PleI	GAGTC (4/5)	N	yes
Ple19I	CGATCG	I	yes
PmaCI	CACGTG	K	yes
PmeI	GTTTAAAC	N	yes
PmlI	CACGTG	N	yes
PpiI	(7/12) GAACNNNNNCTC (13/8)	F	-
PpsI	GAGTC (4/5)	I	yes
Ppu21I	YACGTR	F	yes
PpuMI	RGGWCCY	NO	yes
PscI	ACATGT	F	yes
PshAI	GACNNNNGTC	KN	yes
PshBI	ATTAAT	K	yes
PsiI	TTATAA	INO	yes
Psp5II	RGGWCCY	F	yes
Psp6I	CCWGG	I	yes
Psp1406I	AACGTT	FK	yes
Psp124BI	GAGCTC	IV	yes
PspCI	CACGTG	IV	yes
PspEI	GGTNACC	IV	yes
PspGI	CCWGG	N	yes
PspLI	CGTACG	I	yes
PspN4I	GGNNCC	I	yes
PspOMI	GGGCCC	INV	yes
PspPI	GGNCC	C	yes
PspPPI	RGGWCCY	I	yes
PspXI	VCTCGAGB	IN	-
PsrI	(7/12) GAACNNNNNNTAC (12/7)	I	-
PstI	CTGCAG	BCFHIJKMNOQRSUVXY	yes
PstNI	CAGNNNCTG	I	yes
PsuI	RGATCY	F	yes
PsyI	GACNNNGTC	F	yes
PteI	GCGCGC	F	yes
PvuI	CGATCG	BFKMNOQRSUXY	yes
PvuII	CAGCTG	BCFHIJKMNOQRSUVXY	yes
RcaI	TCATGA	M	yes
RgaI	GCGATCGC	I	yes
RigI	GGCCGGCC	I	yes
RruI	TCGCGA	F	yes
RsaI	GTAC	BCFHIJMNOQRSVXY	yes
RsaNI	GTAC	I	yes
RseI	CAYNNNNRTG	F	yes
RsrII	CGGWCCG	MNQX	yes
Rsr2I	CGGWCCG	IV	yes
SacI	GAGCTC	FHJKMNOQRSUX	yes
SacII	CCGCGG	HJKNOQRX	yes
SalI	GTCGAC	BCFHIJKMNOQRSUVXY	yes
SapI	GCTCTTC (1/4)	N	yes
SaqAI	TTAA	F	yes
SatI	GCNGC	F	yes
Sau96I	GGNCC	JNOU	yes
Sau3AI	GATC	CHJKMNORSU	yes
SbfI	CCTGCAGG	INOV	yes
ScaI	AGTACT	BCFJKMNOQRSX	yes
SchI	GAGTC (5/5)	F	yes
ScrFI	CCNGG	JNO	yes
SdaI	CCTGCAGG	F	yes
SduI	GDGCHC	F	yes
SetI	ASST	I	-
SexAI	ACCWGGT	MN	yes
SfaAI	GCGATCGC	F	yes
SfaNI	GCATC (5/9)	INV	yes
SfcI	CTRYAG	N	yes
SfiI	GGCCNNNNNGGCC	CFIJKMNOQRSUVX	yes
SfoI	GGCGCC	N	yes
Sfr274I	CTCGAG	IV	yes
Sfr303I	CCGCGG	IV	yes
SfuI	TTCGAA	M	yes
SgeI	5mCNNGNNNNNNNNN	F	-
SgfI	GCGATCGC	R	yes
SgrAI	CRCCGGYG	MN	yes
SgrBI	CCGCGG	C	yes
SgrDI	CGTCGACG	F	-
SgsI	GGCGCGCC	F	yes
SinI	GGWCC	X	yes
SlaI	CTCGAG	C	yes
SmaI	CCCGGG	BCFHIJKMNOQRSUVXY	yes
SmiI	ATTTAAAT	FIKV	yes
SmiMI	CAYNNNNRTG	IV	yes
SmlI	CTYRAG	N	yes
SmoI	CTYRAG	F	yes
SmuI	CCCGC (4/6)	F	yes
SnaBI	TACGTA	CKMNR	yes
SpeI	ACTAGT	BHJKMNOQRSUX	yes
SphI	GCATGC	BCHIJKMNOQRSVX	yes
SrfI	GCCCGGGC	EO	-
Sse9I	AATT	IV	yes
Sse8387I	CCTGCAGG	K	yes
SseBI	AGGCCT	C	yes
SsiI	CCGC (-3/-1)	F	yes
SspI	AATATT	BCFIJKMNOQRSUVX	-
SspDI	GGCGCC	F	yes
SstI	GAGCTC	BC	yes
SstII	CCGCGG	B	yes
StrI	CTCGAG	U	yes
StuI	AGGCCT	BJKMNQRUX	yes
StyI	CCWWGG	CJMNR	yes
StyD4I	CCNGG	N	yes
SwaI	ATTTAAAT	JMN	yes
TaaI	ACNGT	F	yes
TaiI	ACGT	F	yes
TaqI	TCGA	BCFIJKMNOQRSUVXY	yes
TaqII	GACCGA (11/9), CACCCA (11/9)	QX	-
TasI	AATT	F	yes
TatI	WGTACW	F	-
TauI	GCSGC	F	yes
TfiI	GAWTC	N	yes
TliI	CTCGAG	N	yes
Tru1I	TTAA	F	yes
Tru9I	TTAA	IMRV	yes
TscAI	CASTGNN	F	yes
TseI	GCWGC	N	yes
TsoI	TARCCA (11/9)	F	-
Tsp45I	GTSAC	N	yes
Tsp509I	AATT	N	yes
TspDTI	ATGAA (11/9)	QX	yes
TspEI	AATT	O	yes
TspGWI	ACGGA (11/9)	QX	-
TspMI	CCCGGG	N	yes
TspRI	CASTGNN	N	yes
TstI	(8/13) CACNNNNNNTCC (12/7)	F	-
Tth111I	GACNNNGTC	IKNQRVX	yes
Van91I	CCANNNNNTGG	FKM	yes
Vha464I	CTTAAG	V	yes
VneI	GTGCAC	IV	yes
VpaK11BI	GGWCC	K	yes
VspI	ATTAAT	FIRV	yes
XagI	CCTNNNNNAGG	F	yes
XapI	RAATTY	F	yes
XbaI	TCTAGA	BCFHIJKMNOQRSUVXY	yes
XceI	RCATGY	F	yes
XcmI	CCANNNNNNNNNTGG	N	-
XhoI	CTCGAG	BFHJKMNOQRSUXY	yes
XhoII	RGATCY	R	yes
XmaI	CCCGGG	INRUV	yes
XmaJI	CCTAGG	F	yes
XmiI	GTMKAC	F	yes
XmnI	GAANNNNTTC	NRU	yes
XspI	CTAG	K	yes
ZraI	GACGTC	INV	yes
ZrmI	AGTACT	I	yes
Zsp2I	ATGCAT	IV	yes
Test	CCATGA	BCFHJKMNOQRSUXY	yes