AanI	TTATAA	F	yes
AasI	GAC[GATC][GATC][GATC][GATC][GATC][GATC]GTC	F	yes
AatI	AGGCCT	O	yes
AatII	GACGTC	FIKMNORV	yes
AbsI	CCTCGAGG	I	-
AccI	GT[AC][GT]AC	BJKMNOQRSUX	yes
AccII	CGCG	JK	yes
AccIII	TCCGGA	JKR	yes
Acc16I	TGCGCA	IV	yes
Acc65I	GGTACC	FINRV	yes
AccB1I	GG[CT][AG]CC	IV	yes
AccB7I	CCA[GATC][GATC][GATC][GATC][GATC]TGG	IRV	yes
AclI	AACGTT	INV	yes
AcoI	[CT]GGCC[AG]	I	yes
AcsI	[AG]AATT[CT]	IV	yes
AcvI	CACGTG	QX	yes
AcyI	G[AG]CG[CT]C	J	yes
AdeI	CAC[GATC][GATC][GATC]GTG	F	yes
AfaI	GTAC	K	yes
AfeI	AGCGCT	IN	yes
AfiI	CC[GATC][GATC][GATC][GATC][GATC][GATC][GATC]GG	V	yes
AflII	CTTAAG	JKN	yes
AflIII	AC[AG][CT]GT	MN	yes
AgeI	ACCGGT	JNR	yes
AgsI	TT[CG]AA	I	-
AhdI	GAC[GATC][GATC][GATC][GATC][GATC]GTC	N	yes
AhlI	ACTAGT	IV	yes
AjnI	CC[AT]GG	I	yes
AleI	CAC[GATC][GATC][GATC][GATC]GTG	N	yes
AluI	AGCT	BCFHIJKMNOQRSUVXY	yes
AluBI	AGCT	I	yes
Alw21I	G[AT]GC[AT]C	F	yes
Alw44I	GTGCAC	FJO	yes
AlwNI	CAG[GATC][GATC][GATC]CTG	N	yes
Ama87I	C[CT]CG[AG]G	IV	yes
Aor13HI	TCCGGA	K	yes
Aor51HI	AGCGCT	K	yes
ApaI	GGGCCC	BFIJKMNOQRSUVX	yes
ApaLI	GTGCAC	CKNU	yes
ApeKI	GC[AT]GC	N	yes
ApoI	[AG]AATT[CT]	N	yes
AscI	GGCGCGCC	N	yes
AseI	ATTAAT	JNO	yes
AsiGI	ACCGGT	IV	yes
AsiSI	GCGATCGC	N	yes
AspI	GAC[GATC][GATC][GATC]GTC	M	yes
Asp700I	GAA[GATC][GATC][GATC][GATC]TTC	M	yes
Asp718I	GGTACC	M	yes
AspA2I	CCTAGG	IV	yes
AspEI	GAC[GATC][GATC][GATC][GATC][GATC]GTC	M	yes
AspLEI	GCGC	IV	yes
AspS9I	GG[GATC]CC	IV	yes
AssI	AGTACT	U	yes
AsuII	TTCGAA	C	yes
AsuC2I	CC[CG]GG	I	yes
AsuNHI	GCTAGC	IV	yes
AvaI	C[CT]CG[AG]G	BJMNOQRUX	yes
AvaII	GG[AT]CC	JKMNRY	yes
AviII	TGCGCA	M	yes
AvrII	CCTAGG	N	yes
AxyI	CCT[GATC]AGG	J	yes
BaeGI	G[GT]GC[AC]C	N	yes
BalI	TGGCCA	JKQRX	yes
BamHI	GGATCC	BCFHIJKMNOQRSUVXY	yes
BanI	GG[CT][AG]CC	NORU	yes
BanII	G[AG]GC[CT]C	KNORX	yes
BanIII	ATCGAT	O	yes
BasI	CCA[GATC][GATC][GATC][GATC][GATC]TGG	U	yes
BbrPI	CACGTG	MO	yes
BbuI	GCATGC	R	yes
Bbv12I	G[AT]GC[AT]C	IV	yes
BclI	TGATCA	CFJMNORSUY	yes
BcnI	CC[CG]GG	FK	yes
BcuI	ACTAGT	F	yes
BfaI	CTAG	N	yes
BfmI	CT[AG][CT]AG	F	yes
BfoI	[AG]GCGC[CT]	F	yes
BfrI	CTTAAG	MO	yes
BfuCI	GATC	N	yes
BglI	GCC[GATC][GATC][GATC][GATC][GATC]GGC	CFHIJKMNOQRUVXY	yes
BglII	AGATCT	BCFHIJKMNOQRSUVXY	yes
BlnI	CCTAGG	KMS	yes
BlpI	GCT[GATC]AGC	N	yes
BmcAI	AGTACT	V	yes
Bme18I	GG[AT]CC	IV	yes
Bme1390I	CC[GATC]GG	F	yes
BmeRI	GAC[GATC][GATC][GATC][GATC][GATC]GTC	V	yes
BmeT110I	C[CT]CG[AG]G	K	yes
BmgT120I	GG[GATC]CC	K	yes
BmiI	GG[GATC][GATC]CC	V	yes
BmrFI	CC[GATC]GG	V	yes
BmtI	GCTAGC	INV	yes
BoxI	GAC[GATC][GATC][GATC][GATC]GTC	F	yes
Bpu14I	TTCGAA	IV	yes
Bpu1102I	GCT[GATC]AGC	FK	yes
BpuMI	CC[CG]GG	V	yes
BpvUI	CGATCG	V	yes
Bsa29I	ATCGAT	I	yes
BsaAI	[CT]ACGT[AG]	N	yes
BsaBI	GAT[GATC][GATC][GATC][GATC]ATC	N	yes
BsaHI	G[AG]CG[CT]C	N	yes
BsaJI	CC[GATC][GATC]GG	N	yes
BsaWI	[AT]CCGG[AT]	N	yes
Bsc4I	CC[GATC][GATC][GATC][GATC][GATC][GATC][GATC]GG	I	yes
Bse8I	GAT[GATC][GATC][GATC][GATC]ATC	IV	yes
Bse21I	CCT[GATC]AGG	IV	yes
Bse118I	[AG]CCGG[CT]	IV	yes
BseAI	TCCGGA	CM	yes
BseBI	CC[AT]GG	C	yes
BseCI	ATCGAT	C	yes
BseDI	CC[GATC][GATC]GG	F	yes
BseJI	GAT[GATC][GATC][GATC][GATC]ATC	F	yes
BseLI	CC[GATC][GATC][GATC][GATC][GATC][GATC][GATC]GG	F	yes
BsePI	GCGCGC	IV	yes
BseSI	G[GT]GC[AC]C	F	yes
BseX3I	CGGCCG	IV	yes
Bsh1236I	CGCG	F	yes
Bsh1285I	CG[AG][CT]CG	F	yes
BshFI	GGCC	C	yes
BshNI	GG[CT][AG]CC	F	yes
BshTI	ACCGGT	F	yes
BshVI	ATCGAT	V	yes
BsiEI	CG[AG][CT]CG	N	yes
BsiHKAI	G[AT]GC[AT]C	N	yes
BsiHKCI	C[CT]CG[AG]G	QX	yes
BsiSI	CCGG	C	yes
BsiWI	CGTACG	MNO	yes
BslI	CC[GATC][GATC][GATC][GATC][GATC][GATC][GATC]GG	N	yes
BsnI	GGCC	V	yes
BsoBI	C[CT]CG[AG]G	N	yes
Bsp13I	TCCGGA	IV	yes
Bsp19I	CCATGG	IV	yes
Bsp68I	TCGCGA	F	yes
Bsp119I	TTCGAA	F	yes
Bsp120I	GGGCCC	F	yes
Bsp143I	GATC	F	yes
Bsp1286I	G[AGT]GC[ACT]C	JKNR	yes
Bsp1407I	TGTACA	FK	yes
Bsp1720I	GCT[GATC]AGC	IV	yes
BspDI	ATCGAT	N	yes
BspEI	TCCGGA	N	yes
BspFNI	CGCG	I	yes
BspHI	TCATGA	N	yes
BspLI	GG[GATC][GATC]CC	F	yes
BspOI	GCTAGC	F	yes
BspTI	CTTAAG	F	yes
BspT104I	TTCGAA	K	yes
BspT107I	GG[CT][AG]CC	K	yes
BsrFI	[AG]CCGG[CT]	N	yes
BsrGI	TGTACA	N	yes
BssAI	[AG]CCGG[CT]	C	yes
BssECI	CC[GATC][GATC]GG	I	yes
BssHII	GCGCGC	JKMNOQRSX	yes
BssKI	CC[GATC]GG	N	yes
BssMI	GATC	V	yes
BssNI	G[AG]CG[CT]C	V	yes
BssNAI	GTATAC	IV	yes
BssT1I	CC[AT][AT]GG	IV	yes
Bst98I	CTTAAG	R	yes
Bst1107I	GTATAC	FKM	yes
BstACI	G[AG]CG[CT]C	I	yes
BstAFI	CTTAAG	I	yes
BstAPI	GCA[GATC][GATC][GATC][GATC][GATC]TGC	IN	yes
BstAUI	TGTACA	IV	yes
BstBI	TTCGAA	N	yes
BstBAI	[CT]ACGT[AG]	IV	yes
Bst4CI	AC[GATC]GT	IV	yes
BstC8I	GC[GATC][GATC]GC	I	yes
BstDEI	CT[GATC]AG	IV	yes
BstDSI	CC[AG][CT]GG	IV	yes
BstEII	GGT[GATC]ACC	CHJMNORSU	yes
BstENI	CCT[GATC][GATC][GATC][GATC][GATC]AGG	IV	yes
BstFNI	CGCG	IV	yes
BstH2I	[AG]GCGC[CT]	IV	yes
BstHHI	GCGC	IV	yes
BstKTI	GATC	I	yes
BstMBI	GATC	IV	yes
BstMCI	CG[AG][CT]CG	IV	yes
BstMWI	GC[GATC][GATC][GATC][GATC][GATC][GATC][GATC]GC	I	yes
BstNI	CC[AT]GG	N	yes
BstNSI	[AG]CATG[CT]	IV	yes
BstOI	CC[AT]GG	R	yes
BstPI	GGT[GATC]ACC	K	yes
BstPAI	GAC[GATC][GATC][GATC][GATC]GTC	IV	yes
BstSCI	CC[GATC]GG	I	yes
BstSFI	CT[AG][CT]AG	I	yes
BstSLI	G[GT]GC[AC]C	I	yes
BstSNI	TACGTA	IV	yes
BstUI	CGCG	N	yes
Bst2UI	CC[AT]GG	IV	yes
BstXI	CCA[GATC][GATC][GATC][GATC][GATC][GATC]TGG	FHIJKMNOQRVX	yes
BstX2I	[AG]GATC[CT]	IV	yes
BstYI	[AG]GATC[CT]	N	yes
BstZI	CGGCCG	R	yes
BstZ17I	GTATAC	N	yes
Bsu15I	ATCGAT	F	yes
Bsu36I	CCT[GATC]AGG	NR	yes
BsuRI	GGCC	FI	yes
BsuTUI	ATCGAT	X	yes
BtgI	CC[AG][CT]GG	N	yes
BtuMI	TCGCGA	V	yes
Cac8I	GC[GATC][GATC]GC	N	yes
CaiI	CAG[GATC][GATC][GATC]CTG	F	yes
CciI	TCATGA	I	yes
CciNI	GCGGCCGC	IV	yes
CelII	GCT[GATC]AGC	M	yes
CfoI	GCGC	MRS	yes
CfrI	[CT]GGCC[AG]	F	yes
Cfr9I	CCCGGG	FO	yes
Cfr10I	[AG]CCGG[CT]	FKO	yes
Cfr13I	GG[GATC]CC	FO	yes
Cfr42I	CCGCGG	F	yes
ClaI	ATCGAT	BHKMNQRSU	yes
CpoI	CGG[AT]CCG	FK	yes
CsiI	ACC[AT]GGT	F	yes
CspI	CGG[AT]CCG	OR	yes
Csp6I	GTAC	F	yes
Csp45I	TTCGAA	O	yes
CspAI	ACCGGT	C	yes
CviAII	CATG	N	yes
CviJI	[AG]GC[CT]	QX	yes
CviKI-1	[AG]GC[CT]	N	yes
CviQI	GTAC	N	yes
DdeI	CT[GATC]AG	BMNOQRS	yes
DinI	GGCGCC	V	yes
DpnII	GATC	N	yes
DraI	TTTAAA	BFIJKMNOQRSUVXY	yes
DraII	[AG]GG[GATC]CC[CT]	M	yes
DraIII	CAC[GATC][GATC][GATC]GTG	IMNV	yes
DrdI	GAC[GATC][GATC][GATC][GATC][GATC][GATC]GTC	N	yes
DriI	GAC[GATC][GATC][GATC][GATC][GATC]GTC	I	yes
DseDI	GAC[GATC][GATC][GATC][GATC][GATC][GATC]GTC	IV	yes
EaeI	[CT]GGCC[AG]	KN	yes
EagI	CGGCCG	N	yes
Eam1105I	GAC[GATC][GATC][GATC][GATC][GATC]GTC	FK	yes
Ecl136II	GAGCTC	F	yes
EclXI	CGGCCG	MS	yes
Eco24I	G[AG]GC[CT]C	F	yes
Eco32I	GATATC	F	yes
Eco47I	GG[AT]CC	FO	yes
Eco47III	AGCGCT	FMOR	yes
Eco52I	CGGCCG	FKO	yes
Eco72I	CACGTG	F	yes
Eco81I	CCT[GATC]AGG	FKO	yes
Eco88I	C[CT]CG[AG]G	F	yes
Eco91I	GGT[GATC]ACC	F	yes
Eco105I	TACGTA	FO	yes
Eco130I	CC[AT][AT]GG	F	yes
Eco147I	AGGCCT	F	yes
EcoICRI	GAGCTC	IRV	yes
EcoNI	CCT[GATC][GATC][GATC][GATC][GATC]AGG	N	yes
EcoO65I	GGT[GATC]ACC	K	yes
EcoO109I	[AG]GG[GATC]CC[CT]	FJKN	yes
EcoRI	GAATTC	BCFHIJKMNOQRSUVXY	yes
EcoRII	CC[AT]GG	FJMOS	yes
EcoRV	GATATC	BCHIJKMNOQRSUVXY	yes
EcoT14I	CC[AT][AT]GG	K	yes
EcoT22I	ATGCAT	KO	yes
EcoT38I	G[AG]GC[CT]C	J	yes
Eco53kI	GAGCTC	N	yes
EgeI	GGCGCC	I	yes
EheI	GGCGCC	FO	yes
ErhI	CC[AT][AT]GG	IV	yes
FaeI	CATG	I	yes
FaiI	[CT]AT[AG]	I	-
FatI	CATG	IN	yes
FauNDI	CATATG	IV	yes
FbaI	TGATCA	K	yes
FblI	GT[AC][GT]AC	IV	yes
Fnu4HI	GC[GATC]GC	N	yes
FriOI	G[AG]GC[CT]C	IV	yes
FseI	GGCCGGCC	N	yes
FspI	TGCGCA	JNO	yes
FspAI	[AG]TGCGCA[CT]	F	-
FspBI	CTAG	F	yes
Fsp4HI	GC[GATC]GC	I	yes
HaeII	[AG]GCGC[CT]	JKNOR	yes
HaeIII	GGCC	BHIJKMNOQRSUXY	yes
HapII	CCGG	K	yes
HhaI	GCGC	BFJKNOQRUY	yes
Hin1I	G[AG]CG[CT]C	FKO	yes
Hin1II	CATG	F	yes
Hin6I	GCGC	F	yes
HinP1I	GCGC	N	yes
HincII	GT[CT][AG]AC	BFHJKNOQRUXY	yes
HindII	GT[CT][AG]AC	IMV	yes
HindIII	AAGCTT	BCFHIJKMNOQRSUVXY	yes
HinfI	GA[GATC]TC	BCFHIJKMNOQRUVXY	yes
HpaI	GTTAAC	BCHIJKMNOQRSUVX	yes
HpaII	CCGG	BFIMNOQRSUVX	yes
Hpy8I	GT[GATC][GATC]AC	F	yes
Hpy99I	CG[AT]CG	N	yes
Hpy166II	GT[GATC][GATC]AC	N	yes
Hpy188I	TC[GATC]GA	N	yes
Hpy188III	TC[GATC][GATC]GA	N	yes
HpyCH4III	AC[GATC]GT	N	yes
HpyCH4IV	ACGT	N	yes
HpyCH4V	TGCA	N	yes
HpyF3I	CT[GATC]AG	F	yes
HpyF10VI	GC[GATC][GATC][GATC][GATC][GATC][GATC][GATC]GC	F	yes
Hsp92I	G[AG]CG[CT]C	R	yes
Hsp92II	CATG	R	yes
HspAI	GCGC	IV	yes
KasI	GGCGCC	N	yes
KflI	GGG[AT]CCC	F	yes
KpnI	GGTACC	BCFHIJKMNOQRSUVXY	yes
Kpn2I	TCCGGA	F	yes
KspI	CCGCGG	MS	yes
Ksp22I	TGATCA	IV	yes
KspAI	GTTAAC	F	yes
Kzo9I	GATC	I	yes
MabI	ACC[AT]GGT	I	yes
MaeI	CTAG	M	yes
MaeII	ACGT	M	yes
MaeIII	GT[GATC]AC	M	-
MauBI	CGCGCGCG	F	-
MboI	GATC	BCFKNQRUXY	yes
MfeI	CAATTG	N	yes
MflI	[AG]GATC[CT]	K	yes
MhlI	G[AGT]GC[ACT]C	IV	yes
MlsI	TGGCCA	F	yes
MluI	ACGCGT	BFHIJKMNOQRSUVX	yes
MluCI	AATT	N	yes
MluNI	TGGCCA	M	yes
Mly113I	GGCGCC	I	yes
Mph1103I	ATGCAT	F	yes
MreI	CGCCGGCG	F	yes
MroI	TCCGGA	MO	yes
MroNI	GCCGGC	IV	yes
MroXI	GAA[GATC][GATC][GATC][GATC]TTC	IV	yes
MscI	TGGCCA	BNO	yes
MseI	TTAA	BN	yes
MslI	CA[CT][GATC][GATC][GATC][GATC][AG]TG	N	yes
MspI	CCGG	FHIJKMNOQRSUVXY	yes
Msp20I	TGGCCA	IV	yes
MspA1I	C[AC]GC[GT]G	INRV	yes
MspCI	CTTAAG	C	yes
MspR9I	CC[GATC]GG	I	yes
MssI	GTTTAAAC	F	yes
MunI	CAATTG	FKM	yes
MvaI	CC[AT]GG	FMOS	yes
MvnI	CGCG	M	yes
MvrI	CGATCG	U	yes
MwoI	GC[GATC][GATC][GATC][GATC][GATC][GATC][GATC]GC	N	yes
NaeI	GCCGGC	CKMNOU	yes
NarI	GGCGCC	JMNOQRUX	yes
NciI	CC[CG]GG	JNOR	yes
NcoI	CCATGG	BCFHJKMNOQRSUXY	yes
NdeI	CATATG	BFJKMNQRSXY	yes
NdeII	GATC	JMR	yes
NgoMIV	GCCGGC	N	yes
NheI	GCTAGC	BCFJKMNOQRSUX	yes
NlaIII	CATG	N	yes
NlaIV	GG[GATC][GATC]CC	N	yes
NmuCI	GT[CG]AC	F	yes
NotI	GCGGCCGC	BCFHJKMNOQRSUXY	yes
NruI	TCGCGA	BCIJKMNOQRUX	yes
NsbI	TGCGCA	FK	yes
NsiI	ATGCAT	BHJMNQRSU	yes
NspI	[AG]CATG[CT]	MN	yes
NspV	TTCGAA	JO	yes
OliI	CAC[GATC][GATC][GATC][GATC]GTG	F	yes
PacI	TTAATTAA	FNO	-
PaeI	GCATGC	F	yes
PaeR7I	CTCGAG	N	yes
PagI	TCATGA	F	yes
PalAI	GGCGCGCC	I	yes
PasI	CCC[AT]GGG	F	-
PauI	GCGCGC	F	yes
PceI	AGGCCT	IV	yes
PciI	ACATGT	IN	yes
PdiI	GCCGGC	F	yes
PdmI	GAA[GATC][GATC][GATC][GATC]TTC	F	yes
PfeI	GA[AT]TC	F	yes
Pfl23II	CGTACG	F	yes
PflFI	GAC[GATC][GATC][GATC]GTC	N	yes
PflMI	CCA[GATC][GATC][GATC][GATC][GATC]TGG	N	yes
PfoI	TCC[GATC]GGA	F	-
PhoI	GGCC	N	yes
PinAI	ACCGGT	BMQX	yes
Ple19I	CGATCG	I	yes
PmaCI	CACGTG	K	yes
PmeI	GTTTAAAC	N	yes
PmlI	CACGTG	N	yes
Ppu21I	[CT]ACGT[AG]	F	yes
PpuMI	[AG]GG[AT]CC[CT]	NO	yes
PscI	ACATGT	F	yes
PshAI	GAC[GATC][GATC][GATC][GATC]GTC	KN	yes
PshBI	ATTAAT	K	yes
PsiI	TTATAA	INO	yes
Psp5II	[AG]GG[AT]CC[CT]	F	yes
Psp6I	CC[AT]GG	I	yes
Psp1406I	AACGTT	FK	yes
Psp124BI	GAGCTC	IV	yes
PspCI	CACGTG	IV	yes
PspEI	GGT[GATC]ACC	IV	yes
PspGI	CC[AT]GG	N	yes
PspLI	CGTACG	I	yes
PspN4I	GG[GATC][GATC]CC	I	yes
PspOMI	GGGCCC	INV	yes
PspPI	GG[GATC]CC	C	yes
PspPPI	[AG]GG[AT]CC[CT]	I	yes
PspXI	[ACG]CTCGAG[CGT]	IN	-
PstI	CTGCAG	BCFHIJKMNOQRSUVXY	yes
PstNI	CAG[GATC][GATC][GATC]CTG	I	yes
PsuI	[AG]GATC[CT]	F	yes
PsyI	GAC[GATC][GATC][GATC]GTC	F	yes
PteI	GCGCGC	F	yes
PvuI	CGATCG	BFKMNOQRSUXY	yes
PvuII	CAGCTG	BCFHIJKMNOQRSUVXY	yes
RcaI	TCATGA	M	yes
RgaI	GCGATCGC	I	yes
RigI	GGCCGGCC	I	yes
RruI	TCGCGA	F	yes
RsaI	GTAC	BCFHIJMNOQRSVXY	yes
RsaNI	GTAC	I	yes
RseI	CA[CT][GATC][GATC][GATC][GATC][AG]TG	F	yes
RsrII	CGG[AT]CCG	MNQX	yes
Rsr2I	CGG[AT]CCG	IV	yes
SacI	GAGCTC	FHJKMNOQRSUX	yes
SacII	CCGCGG	HJKNOQRX	yes
SalI	GTCGAC	BCFHIJKMNOQRSUVXY	yes
SaqAI	TTAA	F	yes
SatI	GC[GATC]GC	F	yes
Sau96I	GG[GATC]CC	JNOU	yes
Sau3AI	GATC	CHJKMNORSU	yes
SbfI	CCTGCAGG	INOV	yes
ScaI	AGTACT	BCFJKMNOQRSX	yes
ScrFI	CC[GATC]GG	JNO	yes
SdaI	CCTGCAGG	F	yes
SduI	G[AGT]GC[ACT]C	F	yes
SetI	A[CG][CG]T	I	-
SexAI	ACC[AT]GGT	MN	yes
SfaAI	GCGATCGC	F	yes
SfcI	CT[AG][CT]AG	N	yes
SfiI	GGCC[GATC][GATC][GATC][GATC][GATC]GGCC	CFIJKMNOQRSUVX	yes
SfoI	GGCGCC	N	yes
Sfr274I	CTCGAG	IV	yes
Sfr303I	CCGCGG	IV	yes
SfuI	TTCGAA	M	yes
SgfI	GCGATCGC	R	yes
SgrAI	C[AG]CCGG[CT]G	MN	yes
SgrBI	CCGCGG	C	yes
SgrDI	CGTCGACG	F	-
SgsI	GGCGCGCC	F	yes
SinI	GG[AT]CC	X	yes
SlaI	CTCGAG	C	yes
SmaI	CCCGGG	BCFHIJKMNOQRSUVXY	yes
SmiI	ATTTAAAT	FIKV	yes
SmiMI	CA[CT][GATC][GATC][GATC][GATC][AG]TG	IV	yes
SmlI	CT[CT][AG]AG	N	yes
SmoI	CT[CT][AG]AG	F	yes
SnaBI	TACGTA	CKMNR	yes
SpeI	ACTAGT	BHJKMNOQRSUX	yes
SphI	GCATGC	BCHIJKMNOQRSVX	yes
SrfI	GCCCGGGC	EO	-
Sse9I	AATT	IV	yes
Sse8387I	CCTGCAGG	K	yes
SseBI	AGGCCT	C	yes
SspI	AATATT	BCFIJKMNOQRSUVX	-
SspDI	GGCGCC	F	yes
SstI	GAGCTC	BC	yes
SstII	CCGCGG	B	yes
StrI	CTCGAG	U	yes
StuI	AGGCCT	BJKMNQRUX	yes
StyI	CC[AT][AT]GG	CJMNR	yes
StyD4I	CC[GATC]GG	N	yes
SwaI	ATTTAAAT	JMN	yes
TaaI	AC[GATC]GT	F	yes
TaiI	ACGT	F	yes
TaqI	TCGA	BCFIJKMNOQRSUVXY	yes
TasI	AATT	F	yes
TatI	[AT]GTAC[AT]	F	-
TauI	GC[CG]GC	F	yes
TfiI	GA[AT]TC	N	yes
TliI	CTCGAG	N	yes
Tru1I	TTAA	F	yes
Tru9I	TTAA	IMRV	yes
TscAI	CA[CG]TG[GATC][GATC]	F	yes
TseI	GC[AT]GC	N	yes
Tsp45I	GT[CG]AC	N	yes
Tsp509I	AATT	N	yes
TspEI	AATT	O	yes
TspMI	CCCGGG	N	yes
TspRI	CA[CG]TG[GATC][GATC]	N	yes
Tth111I	GAC[GATC][GATC][GATC]GTC	IKNQRVX	yes
Van91I	CCA[GATC][GATC][GATC][GATC][GATC]TGG	FKM	yes
Vha464I	CTTAAG	V	yes
VneI	GTGCAC	IV	yes
VpaK11BI	GG[AT]CC	K	yes
VspI	ATTAAT	FIRV	yes
XagI	CCT[GATC][GATC][GATC][GATC][GATC]AGG	F	yes
XapI	[AG]AATT[CT]	F	yes
XbaI	TCTAGA	BCFHIJKMNOQRSUVXY	yes
XceI	[AG]CATG[CT]	F	yes
XcmI	CCA[GATC][GATC][GATC][GATC][GATC][GATC][GATC][GATC][GATC]TGG	N	-
XhoI	CTCGAG	BFHJKMNOQRSUXY	yes
XhoII	[AG]GATC[CT]	R	yes
XmaI	CCCGGG	INRUV	yes
XmaJI	CCTAGG	F	yes
XmiI	GT[AC][GT]AC	F	yes
XmnI	GAA[GATC][GATC][GATC][GATC]TTC	NRU	yes
XspI	CTAG	K	yes
ZraI	GACGTC	INV	yes
ZrmI	AGTACT	I	yes
Zsp2I	ATGCAT	IV	yes
Test	CCATGA	BCFHJKMNOQRSUXY	yes